╔═════════════════════╗
║  ⌂                 ░║
║          ⌂   ⌂     ░║
║           ║     ║  ░║
║       ⌂   ║ ⌂⌂     ░║
║           ║   ══╣  ░║
║      ⌂     ⌂       ░║
║      ⌂   ⌂      ║  ░║
║      ⌂      ⌂ ⌂ ║  ░║
║      ⌂          ║  ░║
║      ⌂  ⌂     ⌂⌂   ░║
║       ⌂     ║ ⌂⌂   ░║
║            ═╬═     ░║
║          ⌂  ║⌂⌂    ░║
║      ═╗            ░║
║    ⌂ ░║   ⌂        ░║
║   ⌂   ║        ⌂   ░║
║       ╚═        ⌂  ░║
║      ⌂    ⌂        ░║
║          ⌂         ░║
║        ⌂           ░║
╚═════════════════════╝